#############################################
#       #     # #        ## ####          # E
S ## ##   ### #   ###### #       ########   #
#   ### ####### # #   ## ## ## ####     #####
# #   #         #   # ##     #      ###     #
#############################################
