###############################################
##       #     # #        ## ####          #  E
#S ## ##   ### #   ###### #       ########   ##
##   ### ####### # #   ## ## ## ####     ######
## #   #         #   # ##     #      ###     ##
###############################################
